                                                           
   - - - - - -                                             
   | . . . . |             # # # # # # # # # # # #         
   | . . . . |             #                     #         
   | . $ . . + # # # # # # # #                   #         
   | . . . . |               #             - - - + - - -   
   - - - - - -               #             | . . . . . |   
                             #             | . . . . . |   
                             #             | . . . . . |   
                             #             | . . . . . |   
     - - - - -               #             | . . . . . |   
     | . . . |               # # # # # # # + . . . . . |   
     | . < . + # # #         #             | . . . . . |   
     - - - - -     #         #             | . ? . . . |   
                   # # # # # #             - - - - - - -   
                                                           